-22
23
-13
15
0000000000000000000000000000000000000000000000
0000000000000000000000000000000000000000000000
0000000000000000000000000000000000000000000000
0000000000000000000000000000010000000000000000
0000000000000011100001111000010000000000000000
0000000000000000010111001011010100000000000000
0000000000000000010000000001000100010111000000
0000000000000100010000001001000100010001000000
0000000000000111110011110001111100011101000000
0000000000000100110010001000000000011111000000
0000000000000000010010101000011100000000111000
0000000000010000000010001000010001001000000000
0000000011010000111000000000010101001001110100
0000000000010000000011100000010001001000000100
0000000000010000010010001000000000001000101100
0011000000010000110000001111111111111000000000
0000000000000000100010000000000000000001110000
0000000000011101000011011101111110111000001000
0000000000010001000000001100000000100001101000
0000000000000001000000100001010100011100001000
0000000000010001000000000001000100000001111000
0000000000011111000000000001000100000000000000
0000000000000000001111111101101100000000001100
0000000000000000000000000000000000001110000000
0000100000000111111100000110000000000000110000
0000000000000000000000000000000001111000000000
0000000011000000000000000000000000000000000000
0000000000000000000000111110000000110000000000
0000000000000000000000000000000000000000000000
